SO ./asset/NORD.xpm
F 77,90,53
C 163,80,030
WE ./asset/SUD.xpm
NO ./asset/EST.xpm
EA ./asset/WEST.xpm


11111111111111
10000000000001
10001000000001
10001000100001
10000000000001
10000000000001
10000000000001
10000000000001
10000000000001
100000N0000001
11111111111111
