SO ./asset/NORD.xpm
WE ./asset/SUD.xpm
NO ./asset/EST.xpm
EA ./asset/WEST.xpm

F 77,90,53
C 163,80,30

1111111111111111111111111
1000000000000000000000001
100E000000000000000000001
1000000000000000000000001
1111111111111111111111111